# 명사 
'단수형 | 의미 | 복수형' 의 순서로 정리했다. 중간중간 복수형이 빠져 있는 것도 있다. 이런 것은 문제로 내지 않는다.
단어 옆에 [ ]표기로 적혀있는 것은 발음을 표기한 것이다. 빠져있는 것도 많다. 적혀있지 않은 것은 문제로 내지 않고, 적혀 있는 것 위주로 문제를 낸다.

der Apfel | 사과 | die Äpfel 
das Bier | 맥주 | 
die Chemie | 화학 | 
das Dach | 지붕
das Ei | 계란 | die Eier [아이어]
das Fenster | 창문 | die Fenster
der Gang | 복도 | 
das Hähnchen | 치킨 | die Hähnchen
der Igel | 고슴도치 | die Igel
die Jacke | 재킷 | die Jacken [야큰]
die Kirche | 교회 | die Kirchen [키흐션]
die Lampe | 램프, 전등 | die Lampen [람픈]
der Mond | 달 | 
die Sonne | 태양 | 
die Nacht | 밤 | 
das Obst | 과일 | 
der Priester | 신부, 성직자 | die Priester
die Qualität | 품질 | 
das Rad | 바퀴 | die Räder [레이더]
der Stuhl | 의자 | die Stühle
die Tür | 문 | die Türen
die U-Bahn | 지하철
der Vater | 아빠 | die Väter
das Wasser | 물 | 
die Yacht | 요트 | die Yachten
der Zahn | 치아, 이빨 | 
das Öl | 기름
die Übung | 연습
der Tisch | 책상 | die Tische
die Flasche | 병 | die Flaschen [플라션]
das Buch | 책 | die Bücher [뷔셔]
die Tasche | 가방 | 
das Auto | 자동차 | die Autos
das Haus | 집
ich | 나
du | 너
er | 그
sie | 그녀
es | 그것
wir | 우리들
ihr | 너희들
die Studentin | (여)대학생 | die Studentinnen [슈튜덴티넨]
der Student | (남)대학생 | die Studenten [슈투덴튼]
der Hund | 개 | die Hunde [훈더]
die Katze [캇처] | 고양이 | die Katzen [캇츤] 
das Geld | 돈 | die Gelder [겔더]
Zeit | 시간 | 
Angestellte | 직장인(여) | 
Südkorea | 남한 | 
Deutschland | 독일 | 
China | 중국 | 
Frankreich [프항크하이시] | 프랑스 | 
Russland | 러시아 | 
Schweden | 스웨덴 | 
Die Niederlande | 네덜란드 | 
Die Schweiz | 스위스 | 
Deutsch | 독일어 | 
der Kaffee | 커피 | die Kaffees
der Fußball | 축구 | 
das Café | 카페 | die Cafés
die Firma | 회사 | die Firmen [피흐먼]
der Mann | 남자 | die Männer
der Bruder | 남자형제 | die Brüder
die Frau [프하우] | 여자 | die Frauen
die Mutter | 엄마 | die Mütter
die Schwester | 자매 | die Schwester
das Baby | 아기 | die Babys
das Kind [킨트] | 아이 | die Kinder
das Handy | 휴대폰 | die Handys
Verb [베압] | 동사
das Biespiel | 예시
Nominativ | 주격
Genetiv | 소유격
Dativ | ('~에게'로 해석되는) 목적격
Akkusativ | ('~을/를'로 해석되는) 목적격
der Freund | 친구 | die Freunde [프호인더]
die Leute | 사람들
Geburtstag | 생일


움라우트 복붙용 : ä  ö  ü  Ä  Ö  Ü  ß
---

# 동사

규칙적인 단어는 '동사원형 | 의미'만 작성하고, 
불규칙한 경우에는 '동사원형 | 의미 | 현재:나 | 현재:당신 | 현재:그,그녀,그것'의 순서로 정리했다.
규칙적인 단어는 뜻 위주로, 불규칙적인 단어는 뜻 외에 형태변형에 대해 문제를 낸다.
단어 옆에 [ ]표기로 적혀있는 것은 발음을 표기한 것이다. 빠져있는 것도 많다. 적혀있지 않은 것은 문제로 내지 않고, 적혀 있는 것 위주로 문제를 낸다.

machen | 하다 [마흔]
spielen | 놀다
lernen | 배우다
wohnen | 살다
arbeiten | 일하다 | arbeite | arbetest | arbetet
trinken | 마시다
gehen | 가다 [게언]
kommen | 오다 [커먼]
essen | 먹다 [에쓴] | esse [에써] | isst | isst
schlafen | 자다 [슐라픈] | schlafe | schläfst | schläft
reden | 말하다 ['레이든'과 '헤이든'의 중간발음] | rede | redest [헤이디스트] | redet [헤이뎃]
treffen | 만나다 | treffe | triffst | trifft
heißen | ~라고 불리다 | heiße | heißt | heißt
fahren | (차, 비행기 등으로) 가다


움라우트 복붙용 : ä  ö  ü  Ä  Ö  Ü  ß
---

# 숫자

'숫자를 독일어로 풀어쓴 것 | 숫자' 형태. 단어 옆에 [ ]표기로 적혀있는 것은 발음을 표기한 것이다. 빠져있는 것도 많다. 적혀있지 않은 것은 문제로 내지 않고, 적혀 있는 것 위주로 문제를 낸다.

null | 0
eins | 1
zwei | 2
drei | 3
vier | 4
fünf | 5
sechs | 6
sieben | 7
acht | 8
neun | 9
zehn | 10
elf | 11
zwölf | 12
dreizehn | 13
vierzehn | 14
funfzehn | 15
sechzehn | 16 [제히첸]
siebzehn | 17
achtzehn | 18
neunzehn | 19
zwanzig | 20  [츠반치쉬]
dreißig | 30  [트하이씨쉬]
vierzig | 40
fünfzig | 50
sechzig | 60  [제히치쉬]
siebzig | 70 [집치쉬]
achtzig | 80
neunzig | 90
hundert | 100 [훈다흐트]
einundzwanzig | 21 [아인운트츠반치쉬]
siebenunddreißig | 37 [지븐운트트하이치쉬]
einhundertzehn | 110 [아인훈다흐트첸]
einhundertfünfundachtzig | 185 [아인훈다흐트푼프운트아흐치쉬]


움라우트 복붙용 : ä  ö  ü  Ä  Ö  Ü  ß
---

# 시간/요일/날짜 질문

## 시간
시간에 대해 질문한다. "지금 몇시야?" 부터 "~시 ~분이야" 라는 대답에 대해 예를 들어 질문한다.

## 요일
월요일부터 일요일까지 단어를 질문한다.

## 날짜
1월부터 12월까지 단어를 질문한다.
날짜 표현에 들어가는 서수에 대해 질문한다.

---

# 기타

'단어 | 의미' 형태. 단어 옆에 [ ]표기로 적혀있는 것은 발음을 표기한 것이다. 빠져있는 것도 많다. 적혀있지 않은 것은 문제로 내지 않고, 적혀 있는 것 위주로 문제를 낸다.

müde | 피곤한
hier | 여기에(서), 이곳에(서)
und | 그리고(and)
aber | 하지만(but)
heute | 오늘
Ja | Yes
Nein | No
zu Hause | 집에서 [주 하우저]
nach Hause | 집으로 
jetzt | 지금 [예츠트]
im Café | 카페에서 [임 카피이]
Kaffe im Café | 카페에서 커피를 [카페에 임 카피이]
wer | 누가 [비어]
wann | 언제 [바안]
wo | 어디서 [보]
was | 무엇을 [바스]
woher | 어디에서 [보히어]
wohin | 어디로 [보힌]
ins Café | 카페로
in der Firma | 회사에서 [인 데어 피흐마]



움라우트 복붙용 : ä  ö  ü  Ä  Ö  Ü  ß
